NO             textures/wall.xpm
EA     textures/wall.xpm

SO textures/wall.xpm
WE textures/wall.xpm



F textures/ground_13.xpm
C textures/sky.xpm
D textures/door.xpm



    1111111111111111111111111111
        1111000000000100100011111
       11011000001110100100000001
111111110010000001000D0011D110011
1X00000100000000110001011001111
10000001000000001100010010001
10000001000000001100010010001
1000000D000000001100010010001
10000001000X000011000100D0001
11000001110101011110011110N011
11111111 1111111 111111111111
